###########
#######   B
#       # #
# ##### # #
# #####   #
#A#########