###########
#######  XB
#XXXXXXX#X#
#X#####X#X#
#X#####XXX#
#A#########
