###                 #########
#   ###################   # #
# ####                # # # #
# ################### # # # #
#                     # # # #
##################### # # # #
#XXX##OOOOOOOOXX      # # # #
#X#X##O###X##O######### # # #
#X#OOOO#XXX##B#         # # #
#X#O##X################ # # #
###O##XXXXXXXXX    #### # # #
###O############## ## # # # #
###OOOOXXXXXXXXX##    # # # #
######O########X#######X# # #
######O####XXXXXXXXXXXXX#   #
AOOOOOO######################
